{ "1" : 1001,
  "2" : 2001,
  "3" : 1002,
  "4" : 2002,
  "5" : 1003,
  "6" : 2003,
  "7" : 1004,
  "8" : 2004
}

